*******************************
    *             *         * *
*** ***** * ***** * ******* * *
* *     * *     * *   *       *
* ***** * ***** * * * ******* *
*   *   *   *   * * *       * *
*** * *** *** *** * ******* ***
*   * *   *   * * *   *   *   *
* *** * *** *** * *** * ***** *
*   * *   * *   * *     *   * *
*** * ***** * * * ***** * * * *
*   *       * * *     * * *   *
* ************* ***** *** *****
*     *   *         *   * *   *
***** * * * * * ******* * * * *
*     * *   * * *   *   *   * *
* ***** ***** *** * * *** *** *
*     * *   *     * *   * *   *
* *** * *** ******* *** * * * *
* *   *         * *     * * * *
* * *********** * ******* * ***
* *       *   * * *     * *   *
* *** ***** * * * * *** * *** *
* * *     * *   * * * * *   * *
* * ***** * ***** * * * * *** *
* *     * * *     *   * * *   *
* *** *** * ***** *** * * * * *
*     *   *     *     *   * * *
***** * ******* *********** * *
*     *                     *  
*******************************
